33
PLAYING
0
W W W W W W W W W W
W W W W W W W W W W
W W W f g f W W W W
W W W f f f W W W W
W f W f f f W f W W
W f f f f f f f k W
W f f f f f f f f W
W f f f f f f f W W
W W W W W W W W W W
W W W W W W W W W W
_ _ _ _ _ _ _ _ _ _
_ _ _ _ _ _ _ _ _ _
_ _ _ _ _ _ _ _ _ _
_ _ _ R L R _ _ _ _
_ R _ R _ _ _ _ _ _
_ _ _ R R R _ _ _ _
_ R R R _ _ R R _ _
_ P _ R _ _ R _ _ _
_ _ _ _ _ _ _ _ _ _
_ _ _ _ _ _ _ _ _ _