23
PLAYING
0
W W W W W W W W W W 
W W W W W W W W W W 
W W W W W f f W W W 
W W f f f f f W W W 
W W f f f f W W W W 
W f f W W W W W W W 
W f f f f f f W W W 
W f f f f f g W W W 
W W W W W W W W W W 
W W W W W W W W W W 
_ _ _ _ _ _ _ _ _ _ 
_ _ _ _ _ _ _ _ _ _ 
_ _ _ _ _ _ P _ _ _ 
_ _ _ _ E _ _ _ _ _ 
_ _ _ E _ E _ _ _ _ 
_ _ _ _ _ _ _ _ _ _ 
_ _ R _ _ R _ _ _ _ 
_ _ R _ R _ _ _ _ _ 
_ _ _ _ _ _ _ _ _ _ 
_ _ _ _ _ _ _ _ _ _ 