32
PLAYING
0
W W W W W W W W W W 
W W W W W W g W W W 
W W W W W g f f W W 
W W f k W f f f W W 
W W f f f f f f W W 
W W f W f f f f W W 
W W A W W a W W W W 
W W a A a A W W W W 
W W W W W W W W W W 
W W W W W W W W W W 
_ _ _ _ _ _ _ _ _ _ 
_ _ _ _ _ _ _ _ _ _ 
_ _ _ _ _ _ L _ _ _ 
_ _ _ _ _ R R R _ _ 
_ _ E R _ E R _ _ _ 
_ _ _ _ E _ _ P _ _ 
_ _ _ _ _ _ _ _ _ _ 
_ _ _ _ _ _ _ _ _ _ 
_ _ _ _ _ _ _ _ _ _ 
_ _ _ _ _ _ _ _ _ _ 